8	8
x   x   x   x   x   x   x   x 
x   x   1   1   1   1   1   x
x   x   1   x   x   x   1   x
1r  1   1   1   1   x   1   1p
x   x   1   x   x   x   1   x
x   x   1   1   1   1   1   x
x   x   x   x   x   x   x   x
x   x   x   x   x   x   x   x  